prev:           ./maps/lvl3.map (32,27)
next:           ./maps/lvl5.map (16,39)
music:          ./resources/music/happy_adventure.mp3
background:     ./resources/background/dungeon.png
tileset:        ./resources/tileset/tileset.png
tilesize:       (16, 16)

11
B: S(1,9)
C: S(0,7)
D: S(1,7)
E: S(2,7)
F: S(1,0)
G: S(2,5)
H: S(0,0)
I: S(2,0)
K: S(0,18)
N: N(0,6)
P: P(0,6)
_
    KKKK    N       KKKKKKKKKKKKKKKKKKKK
      KKKKK                      KKKKKKK
        KKKKKKK                    KKKKK
         KKKKKKKKKKKKK              KKKK
                    KKK   KK         KKK
                    KK    KK         KKK
 KKKKKKKKKKKKKKKKKKKKKKKKKKKKKKKK  KKKKK
KKKKKKKKKKKKKKKKKKKKKKKKKKKKKKKK   KKKKK
KK                                KKKKKK
KK                              KKKKKKKK
KK                            KKKKKKKKKK
KKKKK          KKKKKKKKKKKKKKKKKKKKKKKKK
KKKKKKK     KKKKKKKKKKKKKKKKKKKKKKKKKKKK
          KKKK                          
         KK                             
                                        
                    KKKKKKKKKKKKKKKKKKKK
KKKKKKKK            KKKKKKKKKKKKKKKKKKKK
  KKKKKKKKK                           KK
    KKKKKKKKKK                        KK
     KKKKKKKKKKKKKKKKKK               KK
      KKKKKKKKKKKKKKKKKKK       KKKKKKK 
                        KK     KKKKKKK  
P                            KK         
                            KK          
                    KK                  
KK                 KKK                  
KK    K  KK  KK  KKKKKK    KKKKKKKKKKKKK
KKK  KK  KK  KK  KKKKKKKKKKKKKKKKKKKKKKK
KKKKKKKKKKKKKKKKKKKKKKKKKKKKKKKKKKKKKKKK
